15 31
$$$$$$$$$$$$$$$$$$$$$$$$$$$$$$$
$$$$$$$$$$$$$$$$$$$$$$$$$$$$$$$
###############################
#p     ** *    * 2 *  *x* *   #
# # # #*# # #*#*# # # #*#*#*# #
#   **    *** 1****   * 2 * * #
# #*#d# # #*# #k#*#*# # # # #*#
#      5     ** **  * * **    #
#b#*# # # # # # # #*# #*#s# # #
#* **      *  *   ****     ***#
# #*# #w#*# # # #*#*# # # # # #
#*    **  *   1   *  **       #
# # # # # # # # #*# # # # # # #
#***   4    *   *  *  3       #
###############################