15 31
$$$$$$$$$$$$$$$$$$$$$$$$$$$$$$$
$$$$$$$$$$$$$$$$$$$$$$$$$$$$$$$
###############################
#p     ** *    * 2 *  *x* *   #
# # #*#*# # #*#*# # # #*#*#*# #
#   *  4  *** 1*      * 2 * * #
#*# #d# # #*# #k#*#*# # # # #*#
#***   *     **  *  *         #
#b# #*# # # # # # #*# #*#s# # #
#*  ****   *  *  *** *  2 *   #
# # # #w#*# # # #*#*# # # # # #
#**** **  *       *           #
#*#*# #5# # # # #*# # # #*# # #
#***        *   *  *  3    ***#
###############################