15 31
$$$$$$$$$$$$$$$$$$$$$$$$$$$$$$$
$$$$$$$$$$$$$$$$$$$$$$$$$$$$$$$
###############################
#p      ** *  1 * 2 *  * * *  #
# # # #*# # #*#*# # # #*#*#*# #
#   *     ***  *      *   * * #
# # # # # #*# # #*#*# # # # #*#
#  f        b**  *  *         #
# # # # # # # # # #*# #*# # # #
#*  *       *  * 1    *       #
# # # # #*# # # #*#*# # # # # #
#*    **  *x 1    *       2   #
# #*# # # # # # #*# # # # # # #
#           *   *  *          #
###############################