15 31
$$$$$$$$$$$$$$$$$$$$$$$$$$$$$$$
$$$$$$$$$$$$$$$$$$$$$$$$$$$$$$$
###############################
#***   ** *  1 * 2 *  * * *   #
# # # #*# # #*#*# # # #*#*#*# #
#****  s  ***  *      * 2 * * #
# # # # # #*# # #*#*# # # # #*#
#**f    b    **  *  *      ***#
# # # # # # # # # #*# #*# #*#*#
#*  *   3   *  * 1    *  2    #
# # # # #*# # # #*#*# # # # # #
#*    **  *  1    *     ******#
#*#*# #*# # # # #*#x# # #*#*#*#
#p      *****   *  *      3   #
###############################