15 31
$$$$$$$$$$$$$$$$$$$$$$$$$$$$$$$
$$$$$$$$$$$$$$$$$$$$$$$$$$$$$$$
###############################
#p     ** *    * 2 *  * * *   #
# # # #*# # #*#*# # # #*#*#*# #
#   *     *** 1*      * 2 * * #
# # # # # #*# # #*#*# # # # #*#
#            **  *  *         #
#b# # # #f# # # # #*# #*#s# # #
#*  *      *  * 1    *  2     #
# # # # #*# # # #*#*# # # # # #
#*    **  *  1    *           #
# #x# # # # # # #*# # # # # # #
#    4      *   *  *  3       #
###############################