15 31
$$$$$$$$$$$$$$$$$$$$$$$$$$$$$$$
$$$$$$$$$$$$$$$$$$$$$$$$$$$$$$$
###############################
#p     ** *    * 2 *  *x* *   #
# # # #*# # #*#*# # # #*#*#*# #
#   *     *** 1*      * 2 * * #
# # #d# # #*# #k#*#*# # # # #*#
#      4     **  *  *         #
#b# # # # # # # # #*# #*#s# # #
#*  *      *  *      *  2     #
# # # #w#*# # # #*#*# # # # # #
#*    **  *       *    3      #
# # # #5# # # # #*# # # # # # #
#           *   *  *  3       #
###############################