15 31
$$$$$$$$$$$$$$$$$$$$$$$$$$$$$$$
$$$$$$$$$$$$$$$$$$$$$$$$$$$$$$$
###############################
#p  w   ** *  1 * 2 *  * * *  #
# # # #*# # #*#*# # # #*#*#*# #
#  x*  s  ***  *      *   * * #
# # # # # #*# # #*#*# # # # #*#
#  f    b    **  *  *         #
# # # # # # # # # #*# #*# # # #
#*  *       *  * 1    *       #
# # # # #*# # # #*#*# # # # # #
#*    **  *  1    *       2   #
# #*# # # # # # #*# # # # # # #
#           *   *  *          #
###############################