15 31
$$$$$$$$$$$$$$$$$$$$$$$$$$$$$$$
$$$$$$$$$$$$$$$$$$$$$$$$$$$$$$$
###############################
#p     ** *    * 2 *  *x* *   #
# # # #*# # #*#*# # # #*#*#*# #
#   *     *** 1*      * 2 * * #
# # #d# # #*# #k#*#*# # # # #*#
#            **  *  *         #
#b# # # # # # # # #*# #*#s# # #
#*  *      *  *      *  2     #
# # # #w#*# # # #*#*# # # # # #
#*    **  *  1    *    5      #
# # # # # # # # #*# # # # # # #
#      4    *   *  *  3       #
###############################