15 31
$$$$$$$$$$$$$$$$$$$$$$$$$$$$$$$
$$$$$$$$$$$$$$$$$$$$$$$$$$$$$$$
###############################
#p  w   ** *    *   *  * * *  #
# # # #*# # #*#*# # # #*#*#*# #
#  x*  s  ***  *      *   * * #
# # # # # #*# # #*#*# # # # #*#
#  f 1  b    **  *  *         #
# # # # # # # # # #*# #*# # # #
#*  *       *  *      *       #
# # # # #*# # # #*#*# # # # # #
#*    **  *       *           #
# #*# # # # # # #*# # # # # # #
#           *   *  *          #
###############################